//floor2
//1为路 0为墙 21石堆 22为门 23为陷阱 3为人物 41为怪物s 42为怪物m 51为楼梯 61为刀 65为药 67炸弹 68钥匙
[9, 9, 9, 9, 9, 9, 9, 9, 9, 9, 9, 9, 9, 9, 9, 9],
[9, 67, 1, 1, 1, 68, 0, 61, 1, 1, 65, 0, 65, 61, 65, 9],
[9, 1, 1, 1, 1, 1, 0, 1, 1, 1, 1, 0, 61, 65, 61, 9],
[9, 1, 1, 1, 1, 1, 0, 1, 41, 1, 1, 21, 65, 61, 65, 9],
[9, 0, 0, 41, 0, 0, 0, 0, 1, 0, 0, 0, 0, 0, 0, 9],
[9, 61, 0, 41, 0, 65, 0, 1, 1, 1, 0, 41, 41, 0, 67, 9],
[9, 68, 0, 1, 22, 41, 0, 42, 42, 1, 0, 1, 1, 1, 9],
[9, 1, 0, 1, 0, 0, 0, 42, 42, 1, 0, 1, 1, 1, 1, 9],
[9, 1, 0, 1, 1, 1, 0, 1, 0, 0, 0, 0, 0, 0, 0, 9],
[9, 1, 0, 42, 42, 1, 0, 1, 0, 0, 0, 0, 0, 68, 1, 9],
[9, 1, 0, 42, 42, 1, 22, 1, 1, 1, 1, 1, 1, 0, 41, 9],
[9, 1, 0, 1, 1, 0, 0, 1, 1, 1, 1, 1, 1, 1, 1, 9],
[9, 1, 0, 1, 1, 0, 0, 0, 0, 0, 0, 0, 0, 1, 1, 9],
[9, 1, 0, 1, 0, 0, 1, 22, 1, 1, 0, 0, 0, 1, 1, 9],
[9, 1, 1, 1, 0, 67, 1,0, 51, 1, 21, 1, 1, 1, 3, 9],
[9, 9, 9, 9, 9, 9, 9, 9, 9, 9, 9, 9, 9, 9, 9, 9],

21石堆*2: (10,14) (11,3)
22门*3: (4,6) (6,10) (7,13)
23陷阱*1: (3,4)
3 人物*1: (14,14)
41怪物s*6: (3,5) (5,6) (8,3) (11,5) (12,5) (14,10)
42怪物m*8: (3,9) (4,9) (3,10) (4,10)
	  (7,6) (8,6) (7,7) (8,7) 
51楼梯*1: (8,14)
61刀*6: (1,5) (7,1) (12,2) (13,1) (13,3) (14,2)
65药*7: (5,5) (10,1) (12,1) (12,3) (13,2) (14,1) (14,3)
67炸弹*3: (1,1) (5,14) (14,5)
68钥匙*3: (1,6) (5,1) (13,9)

