//floor1
//1为路 0为墙 21石堆 22为门 3为人物 41为怪物s 42为怪物m 43为棺材 44为陷阱 51为楼梯 
//61为刀 64为祭坛 65为药 67炸弹 68钥匙
[9, 9, 9, 9, 9, 9, 9, 9, 9, 9, 9, 9, 9, 9, 9, 9],
[9, 1, 1, 1, 1, 0, 64, 68, 68, 1, 21, 1, 1, 0, 51, 9],
[9, 1, 0, 1, 1, 0, 0, 0, 0, 0, 0, 1, 1, 22, 1, 9],
[9, 1, 0, 1, 1, 1, 1, 1, 65, 0, 0, 1, 0, 0, 0, 9],
[9, 1, 0, 1, 1, 1, 1, 1, 67, 21, 0, 44, 0, 68, 1, 9],
[9, 1, 0, 0, 0, 0, 0, 0, 0, 1, 1, 41, 0, 1, 1, 9],
[9, 1, 0, 1, 1, 42, 42, 1, 1, 1, 1, 1, 22, 【1】, 1, 9],      //(13,6)
[9, 1, 0, 1, 1, 42, 42, 1, 1, 1, 1, 0, 0, 0, 65, 9],
[9, 1, 0, 1, 1, 0, 0, 1, 1, 1, 1, 22, 41, 1, 61, 9],
[9, 1, 0, 1, 1, 0, 0, 【1】, 1, 1, 1, 0, 1, 1, 1, 9],	//(7, 9)
[9, 1, 0, 1, 1, 1, 1, 0, 0, 1, 1, 0, 0, 0, 0, 9],
[9, 1, 0, 0, 0, 0, 22, 0, 0, 1, 1, 1, 1, 1, 1, 9],
[9, 1, 1, 1, 1, 1, 1, 41, 68, 0, 1, 1, 1, 1, 1, 9],
[9, 0, 0, 0, 0, 0, 0, 0, 0, 0, 1, 1, 0, 0, 1, 9],
[9, 3, 1, 1, 1, 1, 1, 1, 1, 1, 1, 0, 0, 68, 1, 9],
[9, 9, 9, 9, 9, 9, 9, 9, 9, 9, 9, 9, 9, 9, 9, 9],

21石堆*2: 【9, 4】 (10, 1)
22门*4: (6, 11) (11, 8) (12, 6) (13, 2) 
3 人物*1: (1, 14)
41怪物s*3: (7, 12) 【11, 5】 【12, 8】
42怪物m*4: 【3,9】 【4,9】 【3,10】 【4,10】
44陷阱*1: 【11, 4】
51楼梯*1: (14, 1)
61刀*1: 【14, 8】 
64祭坛*1: 【6, 1】
65药*2: (8, 3) (14, 7)
67炸弹*1: 【8, 4】
68钥匙*5: (7, 1) (8, 1) (8, 12) (13, 4) 【13, 14】


/////////////////////////////////////////////////////////////////////////////////////////////////////////////
//floor2
//1为路 0为墙 21石堆 22为门 3为人物 41为怪物s 42为怪物m 43为棺材 44为陷阱 51为楼梯 
//61为刀 64为祭坛 65为药 67炸弹 68钥匙
[9, 9, 9, 9, 9, 9, 9, 9, 9, 9, 9, 9, 9, 9, 9, 9],
[9, 67, 1, 1, 1, 68, 0, 61, 1, 1, 65, 0, 65, 61, 65, 9],
[9, 1, 1, 1, 1, 1, 0, 1, 1, 1, 1, 0, 61, 65, 61, 9],
[9, 1, 1, 1, 1, 1, 0, 1, 【1】, 1, 41, 21, 65, 61, 65, 9],	//(8, 3)
[9, 0, 0, 44, 0, 0, 0, 0, 1, 0, 21, 21, 0, 0, 0, 9],
[9, 61, 0, 41, 0, 65, 0, 1, 1, 1, 0, 41, 【1】, 1, 67, 9],     //(12, 5)
[9, 68, 0, 1, 22, 65, 0, 42, 42, 1, 0, 1, 1, 1, 9],
[9, 1, 0, 1, 0, 0, 0, 42, 42, 1, 0, 1, 1, 1, 1, 9],
[9, 1, 0, 42, 42, 1, 0, 1, 0, 0, 0, 0, 0, 0, 0, 9],
[9, 1, 0, 42, 42, 1, 0, 1, 0, 0, 0, 0, 0, 68, 1, 9],
[9, 1, 0, 1, 1, 1, 22, 1, 1, 1, 1, 1, 1, 0, 41, 9],
[9, 1, 0, 1, 1, 0, 0, 1, 1, 1, 1, 1, 1, 1, 1, 9],
[9, 1, 0, 1, 1, 0, 0, 0, 0, 0, 0, 0, 0, 1, 1, 9],
[9, 1, 0, 1, 0, 0, 1, 22, 1, 1, 0, 0, 0, 1, 1, 9],
[9, 1, 1, 1, 0, 67, 1,0, 51, 1, 21, 1, 1, 1, 3, 9],
[9, 9, 9, 9, 9, 9, 9, 9, 9, 9, 9, 9, 9, 9, 9, 9],

21石堆*4: (10,14) (11,3) 【10, 4】【11, 4】
22门*3: (4,6) (6,10) (7,13)
3 人物*1: (14,14)
41怪物s*4: (3,5) 【10,3】 (11,5) (14,10)
42怪物m*8: (3,8) (4,8) (3,9) (4,9)
	  (7,6) (8,6) (7,7) (8,7) 
44陷阱*1: 【3, 4】
51楼梯*1: (8,14)
61刀*6: (1,5) (7,1) (12,2) (13,1) (13,3) (14,2)
64祭坛*1: 【12, 7】
65药*8: (5,5) 【5, 6】(10,1) (12,1) (12,3) (13,2) (14,1) (14,3)
67炸弹*4: (1,1) (5,14) 【6, 14】 (14,5)
68钥匙*3: (1,6) (5,1) (13,9)



/////////////////////////////////////////////////////////////////////////////////////////////////////////////
//floor3
//1为路 0为墙 21石堆 22为门 3为人物 41为怪物s 42为怪物m 43为棺材 44为陷阱 51为楼梯 
//61为刀 64为祭坛 65为药 67炸弹 68钥匙
[9, 9, 9, 9, 9, 9, 9, 9, 9, 9, 9, 9, 9, 9, 9, 9],
[9, 0, 0, 0, 0, 0, 1, 1, 1, 1, 0, 0, 0, 0, 0, 9],
[9, 0, 0, 0, 0, 0, 1, 1, 1, 1, 0, 0, 0, 0, 0, 9],
[9, 0, 0, 0, 0, 0, 1, 43, 43, 1, 0, 0, 0, 0, 0, 9],
[9, 0, 0, 0, 0, 0, 1, 43, 43, 1, 0, 0, 0, 0, 0, 9],
[9, 0, 0, 0, 0, 0, 1, 43, 43, 1, 0, 0, 0, 0, 0, 9],
[9, 0, 0, 0, 0, 0, 1, 1, 1, 1, 0, 0, 0, 0, 0, 9],
[9, 0, 0, 0, 0, 0, 0, 42, 42, 0, 0, 0, 0, 0, 0, 9],
[9, 0, 0, 0, 0, 1, 1, 42, 42, 1, 1, 0, 0, 0, 0, 9],
[9, 0, 0, 0, 0, 1, 1 ,1, 1, 1, 1, 0, 0, 0, 0, 9],
[9, 0, 0, 0, 0, 1, 1 ,1, 1, 1, 1, 0, 0, 0, 0, 9],
[9, 0, 0, 0, 0, 1, 1 ,1, 1, 1, 1, 0, 0, 0, 0, 9],
[9, 0, 0, 0, 0, 0, 0, 41, 41, 0, 0, 0, 0, 0, 0, 9],
[9, 0, 0, 0, 0, 0, 1, 1, 1, 1, 0, 0, 0, 0, 0, 9],
[9, 3, 1, 22, 22, 21, 1, 1, 1, 1, 0, 0, 0, 0, 0,  9],
[9, 9, 9, 9, 9, 9, 9, 9, 9, 9, 9, 9, 9, 9, 9, 9],

21石堆*1: 【5, 14】
22门*2: (3, 14) (4, 14)
41怪物s*2: (7, 12) (8, 12)
42怪物m*4: (7, 7) (7, 8) (8, 7) (8, 8)
43棺材*6: (7, 3) (7, 4) (7, 5) (8, 3) (8, 4) (8, 5)

